Xos, Xos, Xos, Xos, Xos, Xos, Xos, Xos, Xos, Xos, Xos, Xos, Xos, Xos
Xos, Xos, Cud^Yd16, Cud^Yd16, Rr^Yd14, Xos, Xos, Xos, Ur^Yd14, Urb^Yd2, Ur, Xos, Xos, Xos
Xos, Cud^Yd16, Rr^Yd16, Rr^Yd15, Rr, Rr^Yd16, Xos, Xos, Xos, Ur, Rr, Ur^Yd16, Rr^Yd14, Xos
Xos, Rr^Yd14, Rr^Yd14, Rr^Yd15, Rr^Pr/, Xos, Cud^Yd15, Cud^Yd15, Rr, Rr^Pr\, Xos, Rr^Yd14, Xos, Xos
Xos, Xos, Xos, Xos, Cud^Yd14, Rr, Rr, Rr, Rr, Rr^Yd16, Cud^Yd16, Xos, Xos, Xos
Xos, Xos, Cud^Yd14, Cud^Yd14, Irs^Yd13, Rr^Ebn, Rr, Rr^Yd11, Rr, Rr, Rr, Cud^Yd16, Xos, Xos
Xos, Cud^Yd14, Urb^Yd4, Irs^Ykit, Irs^Yd12, Irs^Yd10, Irs^Yd16, Rr, Rr, Rr, Rr^Pr/o, Xos, Gg^Eqf, Gg^Eqf
Gd, Xos, Xos, Irs^Yd16, Irs^Yd16, Irs, Irs^Yd12, Irs^Yd15, Xos, Xos, Gg^Eqf, Gg, Gd, Gg^Eqf
Gg, Gg, Gg, Xos, Xos, Irs^Yd14, Xos, Xos, Gg^Eqf, Gg^Eqf, Gg^Eqf, Gg^Eqf, Gg^Eqf, Gd
Gg, Gd, Gg, Gd, Gg, Xos, Gg^Eqf, Gg^Eqf, Gg, Gd, Gg, Gg^Eqf, Gg^Eqf, Gg^Eqf
