Xos, Xos, Xos, Xos, Xos, Xos, Xos, Xos, Xos, Xos, Xos, Xos, Xos, Xos, Xos, Xos, Xos, Xos, Xos, Xos, Xos, Xos, Xos, Xos, Xos, Xos, Xos, Xos, Xos
Xos, Xos, Urb, Xos, Urb^Edb, Xos, Xos, Xos, Urb, Xos, Xos, Xos, Xos, Xos, Urb, Xos, Xos, Xos, Xos, Xos, Cud^Ebn, Xos, Cud, Xos, Cud^Ebn, Xos, Xos, Xos, Xos
Xos, Xos, Urb^Edb, Urb, Urb, Xos, Ur, Uu, Urb^Edt, Urb^Edt, Urb^Edt, Ur, Urb^Edt, Xos, Urb, Xos, Urb, Urb^Edt, Xos, Ur, Ur, Cud, Cud, Cud, Ur, Uu, Rb^Edt, Xos, Xos
Xos, Xos, Ur, Ur^Edb, Ur^Em, Xos, Xos, Ur, Urb^Em, Uu, Xos, Ur^Edt, Urb^Edt, Ur, Urb, Urb, Ur^Edt, Ur, Ur, Ur, Uu, Ur, Ur, Ur, Ur^Edt, Rb, Rb^Edt, Xos, Xos
Xos, Xos, Urb, Ur, Xos, Xos, Xos, Xos, Ur, Ur, Xos, Urb, Xos, Xos, Xos, Xos, Xos, Ur, Xos, Ur, Ur^Es, Ur^Es, Rb, Ur, Rb^Es, Ur, Rb, Xos, Xos
Xos, Xos, Xos, Urb, Urb, Xos, Ur, Uu, Xos, Xos, Urb, Xos, Co, Xos, Rb, Xos, Co, Xos, Uu, Xos, Xos, Rb^Es, Rb, Uu, Ur^Edt, Ur^Edt, Ur^Edt, Xos, Xos
Xos, Xos, Xos, Xos, Xos, Urb, Ur, Xos, Xos, Uu, Uu, Urb, Urb, Ce, Rb, Ce, Urb, Uu, Xos, Xos, Xos, Ur, Xos, Ur, Rb^Edt, Ur^Edt, Xos, Xos, Xos
Xos, Xos, Urb^Ebn, Xos, Xos, Ur^Edb, Ur, Urb, Urb, Xos, Xos, Ur, Ur, Urb, Urb, Ur^Edt, Ur, Ur, Xos, Ur, Ur, Xos, Xos, Xos, Xos, Urb, Urb, Xos, Xos
Xos, Xos, Urb, Urb, Cud, Xos, Xos, Urb, Rb, Urb^Edb, Xos, Uu, Uu, Urb^Edb, Urb, Urb, Xos, Xos, Ur, Ur, Ur, Ur, Xos, Xos, Ur, Uu, Urb^Es, Xos, Xos
Xos, Xos, Cud, Cud, Urb, Urb, Ur, Xos, Urb^Edb, Xos, Rb, Uue, Urb, Xos, Rrc, Xos, Urb, Ur, Uu, Uu, Xos, Ur^Es, Ur, Ur, Ur^Es, Rb, Xos, Xos, Xos
Xos, Xos, Urb, Ur, Urb, Urb, Xos, Xos, Urb, Xos, Urb, Urb, Xos, Xos, Rrc, Xos, Xos, Urb, Urb, Urb, Ur, Xos, Xos, Rb, Xos, Xos, Ur^Es, Xos, Xos
Xos, Xos, Ur^Edb, Xos, Xos, Ur, Uu, Rb, Xos, Xos, Urb, Xos, Rrc, Rrc, Rrc^Qov, Rrc, Rrc, Xos, Urb, Urb^Edb, Ur, Rb, Xos, Xos, Ur, Ur, Ur, Xos, Xos
Xos, Xos, Urb, Xos, Urb, Xos, Xos, Xos, Ur, Uu, Xos, Xos, Xos, Rrc, Rrc, Rrc, Xos, Xos, Ur, Rb, Urb, Xos, Xos, Ur, Xos, Ur^Es, Urb, Xos, Xos
Xos, Xos, Xos, Urb^Edb, Urb, Urb, Xos, Ur, Ur^Edt, Ur^Es, Xos, Uu, Ur, Xos, Xos, Xos, Ur, Ur^Edt, Uu, Uu, Ur, Xos, Xos, Xos, Uu, Urb, Xos, Xos, Xos
Xos, Xos, Uu, Xos, Xos, Xos, Ur, Ur, Xos, Xos, Ur, Ur^Es, Ur^Esd, Urb, Rb, Xos, Xos, Ur^Edt, Ur^Es, Ur, Ur, Ur, Ur, Rb, Xos, Xos, Urb, Xos, Xos
Xos, Xos, Rb^Es, Rb^Edt, Rb^Edt, Ur, Xos, Xos, Urb, Uu, Ur, Ur, Urb, Urb, Urb^Edt, Urb, Xos, Ur, Ur, Ur, Ur, Ur^Es, Ur^Es, Rb^Es, Rb, Ur, Urb^Edt, Xos, Xos
Xos, Xos, Uu, Uue, Rb^Emf, Rb, Rb^Es, Xos, Xos, Urb, Xos, Xos, Urb^Edt, Urb, Urb, Urb, Urb^Edb, Xos, Xos, Uu, Xos, Xos, Ur, Rb, Uu, Ur, Urb, Xos, Xos
Xos, Xos, Rb^Em, Rb^Em, Uue, Rb^Emf, Rb^Em, Uu, Xos, Xos, Urb, Urb, Urb^Edt, Urb^Edt, Urb, Urb, Urb, Urb^Edb, Urb, Xos, Xos, Ur, Rb^Em, Rb^Em, Xos, Rb^Edt, Urb, Xos, Xos
Xos, Xos, Uu, Uu^Edt, Uue, Uue, Rb^Emf, Rb^Em, Rb^Es, Urb, Urb, Urb, Xos, Xos, Urb, Xos, Xos, Urb, Urb^Edt, Urb^Edt, Xos, Xos, Xos, Xos, Wwrg, Rb^Edt, Rb, Xos, Xos
Xos, Xos, Rb^Em, Rb^Emf, Uu, Uue, Uue, Uue, Rb^Es, Urb^Edt, Urb, Xos, Urb, Urb, Urb^Ebn, Urb, Urb^Edb, Xos, Urb, Urb^Edt, Uu, Ur, Uu, Rb, Gll, Wog, Gll, Xos, Xos
Xos, Xos, Xos, Rb, Xos, Rb^Es, Xos, Rb^Es, Xos, Xos, Xos, Xos, Xos, Urb, Urb, Urb, Xos, Xos, Xos, Xos, Xos, Urb, Xos, Gll, Xos, Gll, Xos, Xos, Xos
Xos, Xos, Xos, Xos, Xos, Xos, Xos, Xos, Xos, Xos, Xos, Xos, Xos, Xos, Xos, Xos, Xos, Xos, Xos, Xos, Xos, Xos, Xos, Xos, Xos, Xos, Xos, Xos, Xos
