Xoi, Xoi, Xoi, Xoi, Xoi, Xos, Xos, Xos, Xos, Xos, Xos, Xos, Xos, Xos, Xos, Xos, Xos, Xos, Xos, Xos, Xos, Xos, Xoi, Xoi, Xoi, Xoi, Xoi
Xoi, Xoi, Xoi, Xoi, Ch, Xoi, Xoi^Efs, Xos, Xos, Xos, Xoi, Xoi, Xoi, Xoi, Xoi, Xoi, Xoi, Xos, Xos, Xos, Xoi, Xoi, Ch, Xoi, Xoi^Efs, Xoi, Xoi
Xoi, Xoi^Efs, Chr, Chr, Ch^Edt, Ch^Edt, Ch^Edt, Xoi, Xoi, Xos, Xoi^Efs, Xoi, Ch^Es, Ch, Chr, Xoi^Efs, Xoi, Xos, Xoi, Xoi^Efs, Ch, Ch, Ch^Edt, Ch^Edt, Ch, Xoi, Xoi
Xoi, Ch, Chr, Chr, Ior, Ch, Chr, Ch, Ch, Xoi, Ch^Edt, Ch^Edt, Ch^Edt, Ch^Edt, Ch^Es, Chr, Ch, Xoi, Chr, Ch, Chr, Ch^Edt, Iwr, Ch^Edt, Ch^Edt, Ch^Edt, Xoi
Xoi, Chr, Ior^Es, Ior, Ior, Iwr, Iwr, Chr, Ch, Xoi, Ch, Chr, Ior^Edt, Ior^Edt, Iwr, Chr, Ch, Xoi, Chr, Chr, Ior, Ior, Iwr, Iwr, Ior, Ch, Xoi
Xoi, Iwr, Ior, Ior, Ior, Cf^Edt, Iwr, Iwr, Iwr, Xoi^Efs, Iwr, Ior, Iwr, Iwr^Edt, Ior, Iwr^Es, Iwr, Xoi^Efs, Iwr, Ior, Iwr^Edt, Cf^Edt, Ior, Ior^Edt, Iwr, Iwr, Xoi
Xoi, Ior^Es, Iwr, Cf^Edt, Iwr^Edt, Ior, Iwr^Edt, Cfr, Iwr, Ior, Iwr, Iwr^Edb, Iwr, Cv^Edb, Iwr, Iwr, Ior, Iwr, Iwr, Cf^Edt, Iwr, Iwr^Edt, Iwr, Cfr, Iwr, Iwr, Xoi
Xoi, Xoi, Xoi, Iwr, Iwr, Cf^Edt, Iwr, Ior, Iwr, Xoi, Iwr, Cv^Edt, Ior, Iwr, Iwr, Cvr, Iwr, Xoi, Ior, Ior, Iwr, Cf^Edt, Iwr, Iwr, Xoi, Xoi, Xoi
Xoi, Rrc, Rrc, Xoi, Rr^Pw\o, Iwr, Iwr, Cf^Edt, Ior, Xoi, Iwr, Ior, Iwr, Cv^Edt, Ior, Iwr^Edt, Iwr^Edt, Xoi, Iwr, Cfr, Iwr, Iwr, Rr^Pw/o, Xoi, Rrc, Ur, Xoi
Xoi, Rrc, Cvr, Rrc, Ur^Es, Xoi, Xoi, Iwr, Iwr, Xoi, Ior^Es, Cv^Es, Ior, Ior, Iwr, Cv^Edt, Iwr^Edt, Xoi, Iwr, Iwr, Xoi, Xoi, Rrc, Rrc, Cv, Ur, Xoi
Xos, Ur, Ur, Rrc^Es, Cv^Edb, Ur, Ur, Xoi, Xoi, Xoi, Iwr, Ior, Xoi, Xoi, Xoi, Iwr, Ior, Xoi, Xoi, Xoi, Rrc, Rrc^Es, Cvr, Rrc, Ur, Ur, Xoi
Xos, Ur, Cv, Rrc, Ur, Rr, Cv, Rrc, Rrc^Edb, Xoi, Xoi, Xoi, Ur, Ur, Rrc, Xoi, Xoi, Xoi, Rrc, Rrc, Cv, Rrc^Es, Rr, Ur, Cv, Rrc, Xoi
Xos, Rrc, Ur, Rr, Cv^Edb, Ur, Rr^Edb, Rrc, Xoi, Xoi, Rrc^Edt, Ur, Ur, Rrc^Yd12, Rrc^Yd9, Rrc, Rrc, Xoi, Xoi, Rrc, Rrc, Rr, Cvr, Ur, Ur^Edt, Rrc, Xoi
Xoi, Rrc, Rr, Rrc^Edt, Rr, Rrc, Xoi, Rr^Pw/o, Rrc^Edb, Rrc^Yd10, Rrc, Rrc^Yd12, Ur^Edt, Rrc^Yd9, Ur, Rrc^Edb, Rr, Rrc, Rrc, Rr^Pw\, Xoi, Ur, Ur, Rrc, Rrc^Edt, Rrc, Xoi
Iwr, Xoi, Xoi, Rrc, Xoi, Xoi, Rrc, Rr^Edb, Rrc, Ur, Ur^Es, Ur^Edt, Ur^Edt, Rr, Xoi, Ur, Rrc, Rrc^Edb, Rrc^Es, Rrc^Es, Rrc, Xoi, Xoi, Ur, Xoi, Xoi, Iwr
Rrc, Iwr, Iwr, Xoi, Iwr, Xoi, Xoi, Rrc^Es, Rrc, Rrc^Edt, Rrc, Rrc^Edt, Xoi, Rr^Pw/, Rrc, Xoi, Xoi, Rrc, Rrc, Rrc, Xoi, Xoi, Iwr, Xoi, Iwr, Iwr, Rrc
Gs^Fdsu, Rrc, Rrc, Iwr, Iwr, Iwr, Xoi, Xoi, Rr^Pw\, Rrc, Xoi, Xoi, Rrc, Rrc, Rrc^Yd12, Rrc, Rrc, Xoi, Xoi, Xoi, Iwr, Iwr, Rrc, Iwr, Rrc, Rrc, Gg
Gs^Fdsu, Gd, Iwr, Iwr, Xoi, Xoi, Iwr, Iwr, Xoi, Xoi, Xoi, Rrc, Rrc, Rrc, Rrc, Rrc, Xoi, Xoi, Iwr, Iwr^Yd12, Rrc, Rrc, Rrc, Rrc, Gll^Es, Gd, Gll^Efm
Gs, Gll^Efm, Gg, Iwr, Iwr^Yd12, Xoi, Xoi, Iwr, Iwr, Iwr, Iwr, Xoi, Xoi, Rrc, Xoi, Xoi, Iwr^Yd12, Iwr, Rrc, Rrc, Rrc, Rrc, Gll, Gg^Efm, Gd, Gs, Gs^Fdsu
Gs^Fdsu, Gs^Fdsu, Gg, Gd, Gg^Efm, Iwr, Iwr^Yd12, Xoi, Xoi, Iwr, Iwr, Iwr, Iwr, Xoi, Iwr, Iwr, Rrc, Rrc, Rrc, Rrc, Gs^Fdsu, Gg, Gs, Gs^Efm, Gs^Fdsu, Gs^Fdsu, Gs^Fdsu
Gs^Fdsu, Gs^Fdsu, Gg, Gd, Gll, Gll, Gll, Iwr, Iwr, Iwr, Iwr, Iwr, Iwr, Iwr, Rrc, Rrc, Rrc, Rrc, Rrc, Gd, Gs^Fdsu, Gg^Efm, Gll, Gs^Fdsu, Gs^Fdsu, Gs^Fdsu, Gs^Fdsu
Gs^Fdsu, Gs^Fdsu, Gs^Fdsu, Gg, Gs^Fdsu, Gg, Gs^Fdsu, Gg, Gg, Iwr, Iwr, Iwr, Rrc, Rrc, Rrc, Rrc, Gs^Fdsu, Rrc, Rrc, Gs^Fdsu, Gg, Gs^Fdsu, Gs^Fdsu, Gs^Fdsu, Gs^Fdsu, Gs^Fdsu, Gs^Fdsu
Gs^Fdsu, Gs^Fdsu, Gs^Fdsu, Gs^Fdsu, Gs^Fdsu, Gs^Fdsu, Gs^Fdsu, Gg, Gg, Gg, Gg, Rrc, Gg, Rrc, Gs^Fdsu, Gs^Fdsu, Gs^Fdsu, Gs^Fdsu, Gg, Rrc, Rrc, Gs^Fdsu, Gg, Gs^Fdsu, Gs^Fdsu, Gs^Fdsu, Gs^Fdsu
Gs^Fdsu, Gs^Fdsu, Gs^Fdsu, Gs^Fdsu, Gs^Fdsu, Gs^Fdsu, Gs^Fdsu, Gs^Fdsu, Gs^Fdsu, Gs^Fdsu, Gs^Fdsu, Gs^Fdsu, Gs^Fdsu, Gs^Fdsu, Gg, Gg, Gg, Gs^Fdsu, Gs^Fdsu, Gs^Fdsu, Gg, Rrc, Rrc, Gs^Fdsu, Gs^Fdsu, Gs^Fdsu, Gs^Fdsu
