Xoi, Xoi, Xoi, Xoi, Xoi, Xos, Xos, Xos, Xos, Xos, Xos, Xos, Xos, Xos, Xos, Xos, Xos, Xos, Xos, Xos, Xos, Xos, Xoi, Xoi, Xoi, Xoi, Xoi
Xoi, Xoi, Xoi, Xoi, Ch, Xoi, Xoi^Efs, Xos, Xos, Xos, Xoi, Xoi, Xoi, Xoi, Xoi, Xoi, Xoi, Xos, Xos, Xos, Xoi, Xoi, Ch, Xoi, Xoi^Efs, Xoi, Xoi
Xoi, Xoi^Efs, Ch, Ch, Ch^Qov, Ch, Ch, Xoi, Xoi, Xos, Xoi^Efs, Xoi, Ch, Ch, Ch, Xoi^Efs, Xoi, Xos, Xoi, Xoi^Efs, Ch, Ch, Ch^Qov, Ch, Ch, Xoi, Xoi
Xoi, Ch, Ch^Qov, Ch^Qov, Iwr, Ch^Qov, Ch^Qov, Ch, Ch, Xoi, Ch, Ch, Ch^Qov, Ch^Qov, Ch^Qov, Ch, Ch, Xoi, Ch, Ch, Ch^Qov, Ch^Qov, Iwr, Ch^Qov, Ch^Qov, Ch, Xoi
Xoi, Ch^Qov, Iwr, Iwr, Iwr, Iwr, Iwr, Ch^Qov, Ch^Qov, Xoi, Ch^Qov, Ch^Qov, Iwr, Iwr, Iwr, Ch^Qov, Ch^Qov, Xoi, Ch^Qov, Ch^Qov, Iwr, Iwr, Iwr, Iwr, Iwr, Ch^Qov, Xoi
Xoi, Iwr, Iwr, Iwr, Iwr, Cf^Qov, Iwr, Iwr, Iwr, Xoi^Efs, Iwr, Iwr, Iwr, Iwr, Iwr, Iwr, Iwr, Xoi^Efs, Iwr, Iwr, Iwr, Cf^Qov, Iwr, Iwr, Iwr, Iwr, Xoi
Xoi, Iwr, Iwr, Cf^Qov, Iwr, Iwr, Iwr, Cf^Qov, Iwr, Iwr, Iwr, Iwr, Iwr, Cv^Qov, Iwr, Iwr, Iwr, Iwr, Iwr, Cf^Qov, Iwr, Iwr, Iwr, Cf^Qov, Iwr, Iwr, Xoi
Xoi, Xoi, Xoi, Iwr, Iwr, Cf^Qov, Iwr, Iwr, Iwr, Xoi, Iwr, Cv^Qov, Iwr, Iwr, Iwr, Cv^Qov, Iwr, Xoi, Iwr, Iwr, Iwr, Cf^Qov, Iwr, Iwr, Xoi, Xoi, Xoi
Xoi, Rrc, Rrc, Xoi, Rr^Pw\, Iwr, Iwr, Cf^Qov, Iwr, Xoi, Iwr, Iwr, Iwr, Cv^Qov, Iwr, Iwr, Iwr, Xoi, Iwr, Cf^Qov, Iwr, Iwr, Rr^Pw/, Xoi, Rrc, Rrc, Xoi
Xoi, Rrc, Cv^Qov, Rrc, Rrc, Xoi, Xoi, Iwr, Iwr, Xoi, Iwr, Cv^Qov, Iwr, Iwr, Iwr, Cv^Qov, Iwr, Xoi, Iwr, Iwr, Xoi, Xoi, Rrc, Rrc, Cv^Qov, Rrc, Xoi
Xos, Rrc, Rrc, Rrc, Cv^Qov, Rrc, Rrc, Xoi, Xoi, Xoi, Iwr, Iwr, Xoi, Xoi, Xoi, Iwr, Iwr, Xoi, Xoi, Xoi, Rrc, Rrc, Cv^Qov, Rrc, Rrc, Rrc, Xoi
Xos, Rrc, Cv^Qov, Rrc, Rrc, Rrc, Cv^Qov, Rrc, Rrc, Xoi, Xoi, Xoi, Rrc, Rrc, Rrc, Xoi, Xoi, Xoi, Rrc, Rrc, Cv^Qov, Rrc, Rrc, Rrc, Cv^Qov, Rrc, Xoi
Xos, Rrc, Rrc, Rrc, Cv^Qov, Rrc, Rrc, Rrc, Xoi, Xoi, Rrc, Rrc, Rrc, Rrc^Yd12, Rrc^Yd9, Rrc, Rrc, Xoi, Xoi, Rrc, Rrc, Rrc, Cv^Qov, Rrc, Rrc, Rrc, Xoi
Xoi, Rrc, Rrc, Rrc, Rrc, Rrc, Xoi, Rr^Pw/, Rrc, Rrc^Yd10, Rrc, Rrc^Yd12, Rrc, Rrc^Yd9, Rrc, Rrc, Rrc, Rrc, Rrc, Rr^Pw\, Xoi, Rrc, Rrc, Rrc, Rrc, Rrc, Xoi
Iwr, Xoi, Xoi, Rrc, Xoi, Xoi, Rrc, Rrc, Rrc, Rrc, Rrc, Rrc, Rrc, Rrc, Xoi, Rrc, Rrc, Rrc, Rrc, Rrc, Rrc, Xoi, Xoi, Rrc, Xoi, Xoi, Iwr
Rrc, Iwr, Iwr, Xoi, Iwr, Xoi, Xoi, Rrc, Rrc, Rrc, Rrc, Rrc, Xoi, Rr^Pw/, Rrc, Xoi, Xoi, Rrc, Rrc, Rrc, Xoi, Xoi, Iwr, Xoi, Iwr, Iwr, Rrc
Gs^Fdsu, Rrc, Rrc, Iwr, Iwr, Iwr, Xoi, Xoi, Rr^Pw\, Rrc, Xoi, Xoi, Rrc, Rrc, Rrc^Yd12, Rrc, Rrc, Xoi, Xoi, Xoi, Iwr, Iwr, Rrc, Iwr, Rrc, Rrc, Gg
Gs^Fdsu, Gd, Iwr, Iwr, Xoi, Xoi, Iwr, Iwr, Xoi, Xoi, Xoi, Rrc, Rrc, Rrc, Rrc, Rrc, Xoi, Xoi, Iwr, Iwr^Yd12, Rrc, Rrc, Rrc, Rrc, Gll^Es, Gd, Gll^Efm
Gs, Gll^Efm, Gg, Iwr, Iwr^Yd12, Xoi, Xoi, Iwr, Iwr, Iwr, Iwr, Xoi, Xoi, Rrc, Xoi, Xoi, Iwr^Yd12, Iwr, Rrc, Rrc, Rrc, Rrc, Gll, Gg^Efm, Gd, Gs, Gs^Fdsu
Gs^Fdsu, Gs^Fdsu, Gg, Gd, Gg^Efm, Iwr, Iwr^Yd12, Xoi, Xoi, Iwr, Iwr, Iwr, Iwr, Xoi, Iwr, Iwr, Rrc, Rrc, Rrc, Rrc, Gs^Fdsu, Gg, Gs, Gs^Efm, Gs^Fdsu, Gs^Fdsu, Gs^Fdsu
Gs^Fdsu, Gs^Fdsu, Gg, Gd, Gll, Gll, Gll, Iwr, Iwr, Iwr, Iwr, Iwr, Iwr, Iwr, Rrc, Rrc, Rrc, Rrc, Rrc, Gd, Gs^Fdsu, Gg^Efm, Gll, Gs^Fdsu, Gs^Fdsu, Gs^Fdsu, Gs^Fdsu
Gs^Fdsu, Gs^Fdsu, Gs^Fdsu, Gg, Gs^Fdsu, Gg, Gs^Fdsu, Gg, Gg, Iwr, Iwr, Iwr, Rrc, Rrc, Rrc, Rrc, Gs^Fdsu, Rrc, Rrc, Gs^Fdsu, Gg, Gs^Fdsu, Gs^Fdsu, Gs^Fdsu, Gs^Fdsu, Gs^Fdsu, Gs^Fdsu
Gs^Fdsu, Gs^Fdsu, Gs^Fdsu, Gs^Fdsu, Gs^Fdsu, Gs^Fdsu, Gs^Fdsu, Gg, Gg, Gg, Gg, Rrc, Gg, Rrc, Gs^Fdsu, Gs^Fdsu, Gs^Fdsu, Gs^Fdsu, Gg, Rrc, Rrc, Gs^Fdsu, Gg, Gs^Fdsu, Gs^Fdsu, Gs^Fdsu, Gs^Fdsu
Gs^Fdsu, Gs^Fdsu, Gs^Fdsu, Gs^Fdsu, Gs^Fdsu, Gs^Fdsu, Gs^Fdsu, Gs^Fdsu, Gs^Fdsu, Gs^Fdsu, Gs^Fdsu, Gs^Fdsu, Gs^Fdsu, Gs^Fdsu, Gg, Gg, Gg, Gs^Fdsu, Gs^Fdsu, Gs^Fdsu, Gg, Rrc, Rrc, Gs^Fdsu, Gs^Fdsu, Gs^Fdsu, Gs^Fdsu
