Gs^Fdsu, Gs^Fds, Gs^Fdsu, Gs^Fds, Gs^Fdsu, Gs^Fdsu, Gs, Gs^Fds, Gs, Gs, Gd, Rd, Rd, Rd, Iwr, Iwr, Xoc, Xoc, Xoc, Iwr, Iwr^Yd15, Rd, Rd, Rd
Gs^Fdsu, Gs^Fds, Gs^Fdsu, Gs^Fdsu, Gs, Gs^Fds, Gg, Gg, Rd, Rd, Rd, Rd, Iwr, Iwr, Xoc, Xoc, Iwr^Yd14, Urb^Yd4, Iwr^Yd13, Xoc, Xoc, Iwr^Yd15, Iwr, Rd
Gs^Fds, Gs^Fdsu, Gs, Gs, Gs^Fds, Gd, Rd, Rd, Rd, Rd, Iwr, Iwr, Xoc, Xoc, Xoc, Ior^Yd14, Iwr, Iwr, Iwr, Iwr^Yd16, Iwr, Iwr, Xoc, Iwr
Gs^Fdsu, Gs^Fdsu, Gs, Gg, Rd, Rd, Rd, Rd, Iwr, Iwr, Xoc, Rr^Pw/, Iwr, Iwr^Yd14, Iwr, Rr^Pw\, Xoc, Iwr^Yd15, Iwr, Ior, Iwr^Ykit, Ior, Iwr^Yd13, Xoc
Gs, Gs, Rd, Rd, Rd, Rd, Iwr, Iwr, Xoc, Xoc, Iwr^Ykit, Iwr^Ykit, Iwr, Iwr, Ior, Iwr, Xoc, Xoc, Xoc, Iwr^Ykit, Iwr, Iwr, Xof, Xof
Rd, Rd, Rd, Rd, Iwr^Yd16, Iwr^Yd16, Xoc, Xoc, Ket, Xoc, Xoc, Iwr^Yd15, Iwr^Yd13, Iwr, Iwr^Yd9, Xoc, Iwr^Yd13, Iwr^Yd13, Iwr^Yd10, Xoc, Xoc, Xof, Iwr, Iwr
Rd, Rd, Iwr, Iwr, Xoc, Xoc, Ket, Ket, Ket, Ket, Ket^Qov, Xoc, Xoc, Xoc, Iwr, Iwr, Ior, Iwr, Iwr, Iwr, Iwr, Xoc, Xof, Iwr
Iwr, Iwr, Xoc, Rr^Pw/, Iwr, Ket^Qov, Ket^Qov, Ket, Ket^Qov, Ket^Qov, Iwr, Iwr^Yd13, Iwr, Iwr^Yd11, Iwr, Iwr, Iwr, Iwr^Yd11, Iwr, Ior, Xof, Xof, Iwr, Iwr
Xof, Xoc, Iwr, Iwr, Iwr^Yd11, Ior, Iwr, Ket^Qov, Iwr, Ior, Iwr^Yd11, Iwr, Iwr, Iwr, Iwr, Iwr^Yd12, Iwr, Iwr, Xof, Xof, Iwr, Iwr^Yd12, Rrc, Rrc
Iwr, Xof, Xof, Iwr, Iwr, Iwr, Iwr, Iwr, Iwr, Iwr, Iwr, Iwr, Iwr^Yd12, Ior, Iwr, Iwr, Xoc, Xof, Iwr^Yd15, Iwr^Yd13, Rrc, Rrc, Rrc, Rrc
Rrc, Iwr, Iwr^Yd13, Xof, Xof, Iwr, Iwr, Ior^Yd12, Iwr, Ior, Iwr, Iwr, Iwr, Iwr, Xof, Ior, Rr^Pw/o, Xoc, Xof, Rrc, Rrc, Rrc, Rrc, Rrc
Rrc, Rrc, Rrc, Iwr, Iwr, Xof, Xof, Iwr, Iwr, Iwr^Yd11, Iwr, Iwr, Xof, Xof, Iwr, Xof, Xof, Rrc, Rrc, Rrc, Rrc, Rrc, Gg, Gg
Gg, Rrc, Rrc, Rrc, Rrc, Iwr, Iwr, Xof, Xof, Iwr, Xof, Xof, Iwr, Ior^Yd13, Rrc, Rrc, Rrc, Rrc, Rrc, Rrc, Rrc, Gs, Gs^Fds, Gs^Fds
Gs^Fdsu, Gg, Gg, Rrc, Rrc, Rrc, Rrc, Iwr, Iwr, Xof, Iwr, Iwr^Yd12, Rrc, Rrc, Rrc, Rrc, Rrc, Rrc, Rrc, Rrc, Rrc, Rrc, Rrc, Gd
Gs^Fdsu, Gd, Gg, Gg, Gd, Rrc, Rrc, Rrc, Rrc, Iwr, Rrc, Rrc, Rrc, Rrc, Rrc, Rrc, Gg, Gs^Fds, Gs^Fds, Rrc, Rrc, Rrc, Rrc, Rrc
Gs^Fds, Gs^Fds, Gs^Fdsu, Gs, Gg, Gd, Gg, Rrc, Rrc, Rrc, Rrc, Rrc, Rrc, Rrc, Gg, Gs^Fds, Gd, Gd, Gs, Gg, Gg, Rrc, Rrc, Rrc
Gs^Fdsu, Gs^Fds, Gs^Fdsu, Gs^Fdsu, Gs^Fds, Gs^Fds, Gs, Gg, Gg, Rrc, Rrc, Rrc, Gg, Gd, Gg, Gs^Fds, Gs^Fds, Gs, Gg, Gs^Fds, Gs, Gd, Gs^Fds, Rrc
Gs^Fdsu, Gs^Fdsu, Gg, Gs^Fds, Gg, Gs^Fds, Gg, Gd, Gg, Gg, Gg, Gg, Gg, Gg, Gg, Gd, Gg, Gg, Gg, Gg, Gs, Gs, Gg, Gs^Fds
