Gs^Fdsu, Gs^Fdsu, Gs^Fdsu, Gs^Fdsu, Gg, Gg, Gg, Gs^Fdsu, Gs^Fdsu, Gs^Fdsu, Gs^Fdsu, Gs^Fdsu, Gg
Gs^Fdsu, Gg, Gs, Gs^Efm, Gs, Gs^Efm, Gd, Gs, Gs^Fdsu, Gg, Gg, Gs^Fdsu, Gg
Gs^Efm, Gs, Gd, Gd, Xom, Xom, Xom, Gs, Gg, Gs, Gs, Gs^Fdsu, Gg
Gs, Gs^Efm, Xom, Xom, Ior^Yd16, Ior^Ykit, Ior, Xom, Xom, Gs, Gg, Gs^Fdsu, Gg
Xom, Xom, Ior^Yd16, Ior^Yd16, Ior^Yd14, Ior, Rr^Pw/, Xom, Ior^Yd16, Xom, Xom, Gg, Gg
Xom, Ior^Yd14, Ior^Yd14, Ior^Yd14, Xom, Xom, Ior^Yd10, Ior^Qov, Ior, Ior^Yd15, Ior^Yd14, Xom, Xom
Gs, Xom, Xom, Xom, Ior, Ior, Ior, Iwr, Ior^Qov, Ior^Yd12, Ior^Yd13, Ior, Xom
Gs^Efm, Gs, Gs^Eqf, Xom, Rr^Pw\o, Ior, Ior, Ior^Yd12, Ior^Yd16, Ior^Yd16, Xom, Xom, Gg
Gg^Eqf, Gg^Eqf, Rrc, Rrc, Rrc, Xom, Xom, Ior^Yd16, Xom, Xom, Gg, Gs, Gg
Rrc, Rrc, Rrc, Rrc, Gg^Eqf, Gg^Eqf, Gg, Xom, Gg, Gg, Gg^Efm, Gs^Efm, Gg
Rrc, Rrc, Gg^Eqf, Gg^Eqf, Gg, Gg^Efm, Gg, Gg^Efm, Gg, Gg, Gs^Fdsu, Gg, Gg
Gg^Eqf, Gg^Eqf, Gg, Gg, Gg, Gg, Gg, Gg, Gs^Fdsu, Gs^Fdsu, Gs^Fdsu, Gs^Fdsu, Gg
