Gs, Gs, Gs, Gs, Xom, Xom, Xom, Xom, Xom, Gs^Fds, Gs^Fds, Gs^Fds, Xom, Gs^Fds, Gs^Fds, Gs^Fds, Gs^Fds, Gs^Fds, Ds, Ds, Rrc
Gs, Gs, Xom, Xom, Urb^Yd16, Urb^Yd16, Urb^Yd13, Urb, Urb, Xom, Xom, Xom, Ior, Xom, Xom, Gd, Gd, Ds, Rrc, Rrc, Rrc
Xom, Xom, Urb^Yd15, Urb^Yd15, Urb, Urb, Urb, Urb^Yd10, Xom, Xom, Ior^Yd16, Ior^Yd16, Ior, Ior^Yd9, Re, Xom, Rrc, Rrc, Rrc, Rrc, Rrc
Ds, Xom, Xom, Urb, Ur, Ur, Rr^Pw/o, Xom, Ior, Xom, Xom, Ior^Yd14, Re, Re, Rrc, Rrc^Yd12, Rrc, Rrc, Rrc, Rrc, Gs
Gs, Gs, Gs, Ur, Xom, Xom, Ior^Yd13, Ior, Ior, Ior^Yd9, Ds, Xom, Rrc, Rrc, Rrc, Rrc, Rrc, Rrc, Ur, Xom, Xom
Ds, Ds, Xoc, Xom, Xoc, Ior, Ior^Yd9, Ior, Ds, Ds, Rrc, Rrc, Rrc, Rrc, Rrc, Rrc, Ur, Ur, Ior, Ior^Yd11, Ior
Xoc, Xoc, Rrc^Yd10, Rrc^Ykit, Rrc, Xoc, Xoc, Ds, Rrc, Rrc, Rrc, Rrc, Rrc, Rrc, Xom, Xom, Xom, Ior, Ior^Yd12, Ior, Xom
Xoc, Rrc, Rrc, Rrc^Yd10, Xoc, Xoc, Rrc^Yd12, Rrc, Rrc, Rrc, Rrc, Rrc^Yd11, Gd, Ur, Gd, Gd^Yd16, Ur^Yd16, Xom, Xom, Xom, Ds
Ior, Xoc, Xoc, Rrc, Rrc, Rrc, Rrc, Rrc, Rrc, Rrc, Gd, Xom, Xom, Gs^Yd12, Gs, Gs, Ur, Xom, Gs^Yd15, Ds^Yd15, Ds
Xoc, Xoc, Rrc, Rrc, Rrc, Rrc, Rrc, Rrc, Gd, Gd, Ur, Gs, Ur, Xom, Xom, Xom, Ur^Ykit, Gd, Ds, Ds, Ds
Rrc, Rrc, Rrc, Rrc, Rrc, Rrc, Gd, Xom, Xom, Ur^Yd14, Ur^Yd14, Ur^Yd11, Rrc^Yd14, Ur, Ur, Ur^Yd16, Ds, Ds, Ds^Yd11, Ds, Gs
Rrc, Rrc, Rrc, Rrc, Ds, Gd, Ds, Ds, Ds, Xom, Xom, Ur^Yd14, Xom, Xom, Ur, Ds, Ds, Ds, Ds, Gs^Fds, Gs^Fds
Rrc, Rrc, Gd, Gs^Fds, Gs^Fds, Gs^Fds, Gs^Fds, Ur, Gs, Ur, Gs, Xom, Gs, Gs, Gs, Gs, Gs, Gs^Fds, Gs^Fds, Gs^Fds, Gs^Fds
