Gs^Fms, Gs^Fms, Gs^Fms, Gg, Gs^Fms, Gg, Gs^Fms, Gs^Fms, Gs^Fms, Gg, Gg, Gg, Rd, Rd, Kh, Rd, Rd, Gg, Gg, Gs^Fms, Gs^Fms, Gs^Fms, Gg, Gs^Fms, Gs^Fms, Gg, Gg, Gg, Gs^Fms
Gg, Gs^Fms, Gs^Fms, Gs^Fms, Gg, Gg^Efm, Gg^Efm, Gs^Fms, Gg, Gg, Rd, Rd, Xoc, Xoc, Rrc, Xoc, Xoc, Rd, Rd, Gg^Efm, Gs^Fms, Gs^Fms, Gg^Efm, Gs^Fms, Gs^Fms, Gg^Efm, Gs^Fms, Gs^Fms, Gg
Gs^Fms, Gs^Fms, Gg, Gs^Fms, Gg, Gg^Efm, Gg, Gg, Rd, Rd, Xoc, Xoc, Rrc, Rrc, Ch, Rrc, Rrc, Xoc, Xoc, Rd, Rd, Gg, Gg, Gg^Efm, Gg, Gg^Efm, Gs^Fms, Gs^Fms, Gg
Gs^Fms, Gg, Gg^Efm, Gg, Gg, Gs^Fms, Rd, Rd, Xoc, Kh, Rrc, Rrc, Ch, Ch, Rrc, Ch, Ch, Rrc, Rrc, Kh, Xoc, Rd, Rd, Gs^Fms, Gs^Fms, Gs^Fms, Gs^Fms, Gs^Fms, Gg
Gs^Fms, Gs^Fms, Gg, Gg^Efm, Rd, Rd, Xoc, Xoc, Gs^Fms, Gs^Fms, Rrc, Kh, Rrc, Rrc, Kh, Rrc, Rrc, Kh, Rrc, Gs^Fms, Gs^Fms, Xoc, Xoc, Rd, Rd, Gg, Gg, Gs^Fms, Gg
Gg, Gg, Rd^Qov, Rd^Qov, Xoc, Xoc, Gs^Fms, Gs^Fms, Gs^Fms, Gs^Fms, Rrc, Ch, Rrc, Kh, Kh, Kh, Rrc, Ch, Rrc, Gs^Fms, Gs^Fms, Gs^Fms, Gs^Fms, Xoc, Xoc, Rd^Qov, Rd^Qov, Gs^Fms, Gg
Gg, Gs^Fms, Rd^Qov, Kh, Gs^Fms, Xof, Xof, Gs^Fms, Gg, Gs^Fms, Rrc, Kh, Ch, Rrc, Rrc, Rrc, Ch, Kh, Rrc, Gs^Fms, Gg, Gs, Xof, Xof, Gs^Fms, Kh, Rd^Qov, Gg^Efm, Gg^Efm
Gs^Fms, Gg, Rd, Xoc, Rp, Gs^Fms, Gg, Xof, Xof, Gs, Rd, Rrc, Rrc, Ch, Ch, Ch, Rrc, Rrc, Rd, Gg, Xof, Xof, Rr, Gs^Fms, Gs^Fms, Xoc, Rd, Gg, Gg
Gs^Fms, Gs^Fms, Rd, Xoc, Gg^Efm, Gg^Ve, Gs^Fms, Gs^Fms, Gs^Fms, Xof, Xof, Rd, Rd^Qov, Rrc, Rrc, Rrc, Rd^Qov, Rd, Xof, Xof, Gs^Fms, Gg^Ve, Gs^Fms, Gs^Fms, Gs^Fms, Xoc, Rd, Gg, Gg
Gs^Fms, Gs^Fms, Rd, Xoc, Rr^Vhc, Rr, Rr, Rr^Vhc, Rr, Gg^Efm, Gg, Xof, Kh, Xof, Rr^Pw|, Xof, Kh, Xof, Gg, Gs^Fms, Gs^Fms, Rr^Vhc, Rp, Gg^Ve, Rr, Xoc, Rd, Gg, Gg
Gg, Gg, Rd, Xoc, Gs^Fms, Gg^Ve, Cme, Cme, Cme, Rr, Gg^Ve, Rr^Vhc, Rr, Xof, Rrc, Xof, Rr^Vhc, Gg, Rr^Vhc, Rr, Rp, Rp, Wwt, Rr^Vhc, Rr^Vhc, Xoc, Rd, Gs^Fms, Gs^Fms
Gg, Gg^Efm, Rd, Xoc, Gg^Efm, Gs^Fms, Cme, Kv, Cme, Rr^Vhc, Rp, Rr, Gg^Vwm, Rd, Rrc, Rd, Rd, Rr, Cd, Cd, Cd, Rr^Vhc, Wwrt, Ww^Ewf, Gs^Fms, Xoc, Rd, Gs^Fms, Gg
Gs^Fms, Gg^Efm, Gg^Qov, Xoc, Gs^Vh, Gs^Fms, Rr, Cme, Rp, Rp, Rr^Vhc, Rd, Rd, Rrc, Rrc, Rrc, Rrc, Rd, Cd, Kv, Cd, Wwt, Wwt, Wwt, Gs^Fms, Xoc, Gg^Qov, Gg, Gg
Gs^Fms, Gg, Gg^Qov, Kh, Xoc, Gg^Ve, Gs^Vh, Gs^Vh, Rr^Vhc, Gg^Ve, Rrc, Rrc, Ch, Ch, Rr^Pw|o, Ch, Ch, Rrc, Rd, Cd, Gs^Vh, Gs^Vh, Gg^Ve, Rr^Vhc, Xoc, Kh, Gg^Qov, Gs^Fms, Gs^Fms
Gg, Gs^Fms, Gg, Gg^Qov, Gg^Efm, Xoc, Xoc, Rr^Vhc, Rrc, Rd, Ch, Ch, Gs^Vh, Gs^Vh, Rrc, Gs^Vh, Gs^Vh, Ch, Ch, Rrc, Rrc, Rr^Vhc, Xoc, Xoc, Gg, Gg^Qov, Gg, Gs^Fms, Gg
Gs^Fms, Gs^Fms, Gd^Vhr, Gg, Gs^Fms, Gg, Gs^Fms, Xoc, Xoc, Ch, Gs^Vh, Rr^Vhc, Gs^Vh, Gs^Vh, Rd, Gs^Vh, Gs^Vh, Rr^Vhc, Gs^Vh, Ch, Xoc, Xoc, Gs^Fms, Gs^Fms, Gg, Gg^Efm, Gs^Fms, Gs^Fms, Gg
Gs^Fms, Gg, Gs^Fms, Gg, Gg, Gs^Fms, Gd^Vhr, Gg, Gs^Fms, Xoc, Gs^Vh, Gs^Vh, Gs^Vh, Rr^Vhc, Rrc, Gs^Vh, Gs^Vh, Gs^Vh, Gs^Vh, Xoc, Gs^Fms, Gg, Gs^Fms, Gs^Fms, Gs^Fms, Gs^Fms, Gg, Gs^Fms, Gs^Fms
Gg, Gg, Gg, Gg^Efm, Gs^Fms, Gs^Fms, Gs^Fms, Gg^Efm, Gg^Qov, Xoc, Gs^Vh, Rr^Vhc, Gs^Vh, Gs^Vh, Rd, Gs^Vh, Gs^Vh, Gs^Vh, Rr^Vhc, Xoc, Gg^Qov, Gg, Gs^Fms, Gs^Fms, Gg, Gd^Vhr, Gg, Gg, Gg
Gg, Gg, Gs^Fms, Gd^Vhr, Gg, Gg, Gs^Fms, Gs^Fms, Gg^Qov, Kh, Xoc, Gs^Vh, Gs^Vh, Gs^Vh, Rrc, Gs^Vh, Gs^Vh, Gs^Vh, Xoc, Kh, Gg^Qov, Gs^Fms, Gg, Gs^Fms, Gs^Fms, Gg, Gs^Fms, Gg^Efm, Gg
Gs^Fms, Gg, Gg^Efm, Gs^Fms, Gg, Gg^Vwm, Gs^Fms, Gd^Vhr, Gd^Vhr, Gg^Qov, Gg, Xoc, Xoc, Gs^Vh, Rrc, Rr^Vhc, Xoc, Xoc, Gg^Efm, Gg^Qov, Gg, Gs^Fms, Gg^Efm, Gg, Gd^Vhr, Gg, Gg, Gg^Vwm, Gg
Gs^Fms, Gs^Fms, Gs^Fms, Gs^Fms, Gg^Efm, Gs^Fms, Gs^Fms, Gg, Gs^Fms, Gs^Fms, Gs^Fms, Gg, Gg^Qov, Kh, Rr^Pw|, Kh, Gg^Qov, Gg, Gg, Gg^Efm, Gg, Gg, Gg^Efm, Gg, Gg^Efm, Gg, Gs^Fms, Gg, Gg
Gg, Gs^Fms, Gg, Gg, Gg, Gg, Gg, Gg, Gs^Fms, Gg, Gs^Fms, Gs^Fms, Gg, Gg^Qov, Rrc, Gg^Qov, Gg, Gg, Gg, Gg, Gg, Gg, Gg, Gg, Gg, Gs^Fms, Gs^Fms, Gs^Fms, Gg
