Gs^Fdsu, Gs^Fdsu, Gs^Fdsu, Gs^Fdsu, Gs^Fdsu, Gs^Fdsu, Gs^Fdsu, Gs^Fdsu, Gs^Fdsu, Gs^Fdsu, Gs^Fdsu, Gs^Fdsu, Gs^Fdsu, Gs^Fdsu, Gs^Fdsu, Gs^Fdsu, Gs^Fdsu, Gs^Fdsu, Gs^Fdsu, Gs^Fdsu, Gs^Fdsu, Gs^Fdsu, Gs^Fdsu, Gs^Fdsu, Gs^Fdsu, Gs^Fdsu
Gs^Fdsu, Gs^Fdsu, Gs^Fdsu, Gs^Fdsu, Gs^Fdsu, Gs^Fdsu, Gs^Fdsu, Gs^Fdsu, Gs^Fdsu, Gs^Fdsu, Gs^Fdsu, Gs^Fdsu, Gs^Fdsu, Gg, Gs^Fdsu, Gs^Fdsu, Gs^Fdsu, Gs^Fdsu, Gs^Fdsu, Gs^Fdsu, Gs^Fdsu, Gs^Fdsu, Gs^Fdsu, Gs^Fdsu, Gs^Fdsu, Gs^Fdsu
Gs^Fdsu, Gs^Fdsu, Gs^Fdsu, Gs^Fdsu, Gs^Fdsu, Gs^Fdsu, Gs^Fdsu, Gs^Fdsu, Gs^Fdsu, Gs^Fdsu, Gs^Fdsu, Gs^Fdsu, Gg, Gg, Gs^Fdsu, Gs^Fdsu, Gs^Fdsu, Gs^Fdsu, Gs^Fdsu, Gs^Fdsu, Gs^Fdsu, Gs^Fdsu, Gs^Fdsu, Gs^Fdsu, Gs^Fdsu, Gs^Fdsu
Gs^Fdsu, Gs^Fdsu, Gs^Fdsu, Gs^Fdsu, Gs^Fdsu, Gs^Fdsu, Gs^Fdsu, Gs^Fdsu, Gs^Fdsu, Gs^Fdsu, Gs^Fdsu, Gs^Fdsu, Gs^Fdsu, Gg, Gs^Fdsu, Gs^Fdsu, Gs^Fdsu, Gs^Fdsu, Gs^Fdsu, Gs^Fdsu, Gs^Fdsu, Gs^Fdsu, Gs^Fdsu, Gs^Fdsu, Gs^Fdsu, Gs^Fdsu
Gs^Fdsu, Gs^Fdsu, Gs^Fdsu, Gs^Fdsu, Gs^Fdsu, Gs^Fdsu, Gs^Fdsu, Gs^Fdsu, Gs^Fdsu, Gs^Fdsu, Gs^Fdsu, Gs^Fdsu, Gs^Fdsu, Gs^Efm, Gs^Fdsu, Gs^Fdsu, Gs^Fdsu, Gs^Fdsu, Gs^Fdsu, Gs^Fdsu, Gs^Fdsu, Gs^Fdsu, Gs^Fdsu, Gs^Fdsu, Gs^Fdsu, Gs^Fdsu
Gs^Fdsu, Gs^Fdsu, Gs^Fdsu, Gs^Fdsu, Gs^Fdsu, Gs^Fdsu, Gs^Fdsu, Gs^Fdsu, Gs^Fdsu, Gs^Fdsu, Gs^Fdsu, Gs^Fdsu, Gd, Gg, Gs^Fdsu, Gs^Fdsu, Gs^Fdsu, Gs^Fdsu, Gs^Fdsu, Gs^Fdsu, Gs^Fdsu, Gs^Fdsu, Gs^Fdsu, Gs^Fdsu, Gs^Fdsu, Gs^Fdsu
Gs^Fdsu, Gs^Fdsu, Gs^Fdsu, Gs^Fdsu, Gs^Fdsu, Gs^Fdsu, Gs^Fdsu, Gs^Fdsu, Gs^Fdsu, Gs^Fdsu, Gs^Fdsu, Gs^Fdsu, Gg^Efm, Gs^Fdsu, Gs^Fdsu, Gs^Fdsu, Gs^Fdsu, Gs^Fdsu, Gs^Fdsu, Gs^Fdsu, Gs^Fdsu, Gs^Fdsu, Gs^Fdsu, Gs^Fdsu, Gs^Fdsu, Gs^Fdsu
Gs^Fdsu, Gs^Fdsu, Gs^Fdsu, Gs^Fdsu, Gs^Fds, Gs^Fdsu, Gs^Fdsu, Gs^Fdsu, Gs^Fdsu, Gs^Fdsu, Gs^Fdsu, Gs^Fds, Gs^Fds, Gg, Gg, Gs^Fds, Gs^Fds, Gs^Fdsu, Gs^Fds, Gs^Fdsu, Gs^Fdsu, Gs^Fdsu, Gs^Fdsu, Gs^Fdsu, Gs^Fdsu, Gs^Fdsu
Gs^Fdsu, Gs^Fdsu, Gs^Fdsu, Gs^Fds, Gg^Es, Gs^Fds, Gs^Fds, Gs^Fds, Gs^Fds, Gs^Fds, Gs^Fds, Gs^Fdsu, Gs^Fds, Gg, Gs, Gg^Es, Gg, Gs^Fds, Gs^Fds, Gs^Fds, Gs^Fds, Gs^Fds, Gs^Fds, Gs^Fdsu, Gs^Fdsu, Gs^Fdsu
Gs^Fdsu, Gs^Fdsu, Gs^Fds, Gs^Fds, Gg, Gg, Gg, Gs^Fds, Gg, Gg, Gg, Gg, Gg, Gg, Gg, Gs, Gg^Es, Gg, Gg, Gs^Fds, Gg, Gg, Gs^Fds, Gs^Fdsu, Gs^Fds, Gs^Fdsu
Gs^Fds, Gs^Fds, Gs^Fds, Gg, Gg, Gg, Gd^Efm, Gg, Gg, Gg, Gs, Gg, Gd, Gg, Gs^Es, Gs, Gg, Gg, Gg, Gg, Gd, Gg, Gg, Gs^Fds, Gg, Gs^Fdsu
Gg, Gg, Gg, Gg^Efm, Gg, Gg^Efm, Gg, Gs^Es, Gg, Gg^Efm, Gs^Efm, Gg, Gg^Es, Gg, Gs^Es, Gg, Gg^Efm, Gg, Gg, Gg^Es, Gg, Gg, Gg, Gg, Gg, Gg
Gg, Gg^Es, Gg, Gg, Gg, Gs, Gs^Es, Gg, Gg^Efm, Gs, Gg, Gs^Es, Gg, Gg^Es, Gg^Efm, Gs^Efm, Gs, Gs, Gg^Es, Gg, Gg, Gg^Efm, Gg, Gg^Efm, Gg, Gd
Gd, Gg, Gs, Gs, Gg, Gd, Gg, Gg^Efm, Gg, Gg, Gd, Gs, Gg, Gg, Gg, Gg, Gg, Gg, Gg^Efm, Gg, Gg, Gd, Gs, Gg, Gg, Gg
Gg, Gd, Gs, Gg, Gg, Gg, Gg, Gg, Gg, Gg^Es, Gg, Gg, Gg, Gg, Gg, Gg, Gg, Gg, Gg, Gg, Gs, Gs, Gg^Es, Gg, Gs, Gs
Gg, Gg, Gg, Gg, Gg, Gg, Gg, Gg, Gg, Gg, Gg, Gg, Gg, Gg, Gg, Gg, Gg, Gg, Gg, Gg, Gg, Gg, Gg, Gg, Gg, Gs
