Gg, Gg, Gs^Fms, Ds, Gs^Fms, Wwt, Wwt, Ds, Ds, Ds, Gg, Gg, Gg, Gg^Gvs, Gs^Fms, Gg^Gvs, Gs^Fms, Gg, Gs^Fms, Gs^Fms, Gs^Fms, Gg^Gvs
Gg, Gs^Fms, Gg, Gg, Gg, Ds, Ds, Ds, Ds, Gg, Xom, Xom, Rr^Pw\, Gg, Gg, Gs^Fms, Gg, Gg^Gvs, Gg^Gvs, Gs^Fms, Gg^Gvs, Gg^Gvs
Gg, Gs^Fms, Gg^Gvs, Gs^Fms, Gg^Eqf, Ds^Eqf, Gg^Eqf, Ds, Xom, Xom, Iwr^Ykit, Iwr^Yd16, Iwr^Yd16, Xom, Xom, Gg, Gg, Gg, Gg, Gg, Gg^Gvs, Gg^Gvs
Gg, Gg^Gvs, Gg^Eqf, Gg^Eqf, Gg^Gvs, Gg, Xom, Xom, Xom, Iwr^Yd15, Iwr^Yd9, Iwr, Iwr, Iwr^Yd13, Ior^Yd14, Xom, Xom, Gg, Gg, Gg, Gs^Fms, Gs^Fms
Gg^Eqf, Gs^Eqf, Gs^Fds, Gg^Yd12, Xom, Rr^Pw/, Iwr, Iwr^Ebn, Ior, Xom, Rr^Pw\, Ior, Iwr, Ior^Yd14, Xom, Xom, Ior^Yd16, Rr^Pw\, Xom, Gg, Gg^Gvs, Gs^Fms
Gg^Gvs, Gg^Gvs, Xof, Xom, Iwr, Ior, Icn, Icn, Icn, Ior, Iwr, Xom, Xom, Xom, Iwr^Yd16, Iwr^Yd15, Ior^Yd10, Iwr^Yd16, Iwr^Yd16, Xom, Xom, Gg^Gvs
Gg, Gg^Gvs, Gg, Xof, Xom, Icn, Icn, Icn, Icn, Icn, Xom, Xom, Ior, Ior^Ykit, Ior, Iwr, Ior, Iwr^Yd16, Ior^Yd14, Iwr^Yd15, Xof, Xof
Gs^Fms, Gg, Xom, Xom, Ior, Rr^Pw\, Xom, Icn, Rr^Pw/, Xom, Ior, Ior, Gg^Yd12, Iwr, Ior, Ior, Ior, Ior, Xof, Xof, Gg^Gvs, Gg^Gvs
Xof, Xom, Urb^Yd1, Iwr^Yd9, Iwr, Iwr, Xof, Xof, Xof, Ior, Iwr, Ior, Ior, Ior, Iwr, Iwr, Rr^Pw/o, Xof, Gg^Eqf, Gg^Gvs, Gg^Gvs, Gg^Gvs
Gg, Xof, Xof, Ior, Xof, Xof, Gg^Yd14, Gg^Yd14, Gg^Yd13, Xof, Xof, Ior, Iwr^Yd13, Iwr, Xof, Xof, Rr, Rr, Rd, Gg^Eqf, Gg^Eqf, Gg
Gg^Gvs, Gs^Fms, Gg^Gvs, Xof, Gs^Fms, Gg^Gvs, Gg, Gg^Gvs, Gg^Gvs, Gg, Gg, Xof, Xof, Xof, Gg, Gg^Eqf, Gg^Eqf, Rd, Rd, Rd, Rd, Gg^Gvs
Gg, Gg^Gvs, Gg^Gvs, Gg, Uu^Gvs, Gs^Fms, Gg, Gg^Gvs, Gg, Gg^Gvs, Gg, Gg, Gg, Gg^Gvs, Gg^Gvs, Gg^Gvs, Gg^Gvs, Gg^Eqf, Gg^Eqf, Rd, Rd, Rd
