Gs^Fdsu, Gs^Fds, Gs^Fdsu, Gs^Fds, Gs^Fdsu, Gs^Fdsu, Gs, Gs^Fds, Gs, Gs, Gd, Rd, Rd, Rd, Gd, Gg, Gg, Gg, Gs^Fds, Gs^Fds, Gs^Fds, Gs^Fds, Gs^Fds, Gs^Fds
Gs^Fdsu, Gs^Fds, Gs^Fdsu, Gs^Fdsu, Gs, Gs^Fds, Gg, Gg, Rd, Rd, Rd, Rd, Rrc, Rd, Rd, Gg, Gd, Gg, Gg, Gg, Gg, Gg, Gg, Gg
Gs^Fds, Gs^Fdsu, Gs, Gs, Gs^Fds, Gd, Rd, Rd, Rrc, Rrc, Rrc, Rrc, Xoc, Xoc, Xoc, Rd, Rd, Rd, Rd, Gg, Gg, Gs^Fds, Gs^Fds, Gs^Fds
Gs^Fdsu, Gs^Fdsu, Gs, Gg, Rd, Rd, Rrc, Rrc, Rrc, Rrc, Xoc, Rr^Pw/, Iwr, Iwr^Yd14, Iwr, Xoc, Xoc, Rd, Rd, Gd, Rd, Gg, Gg, Gg
Gs, Gs, Rd, Rd, Rd, Rd, Rrc, Rrc, Rrc, Xoc, Iwr^Ykit, Iwr^Ykit, Iwr, Iwr, Ior, Iwr, Xoc, Xoc, Xoc, Rd, Rd, Gd, Gd, Gs^Fds
Rd, Rd, Rd, Rrc, Rrc, Rrc, Rrc, Rrc, Xoc, Xoc, Xoc, Iwr^Yd15, Iwr^Yd13, Iwr, Iwr^Yd9, Xoc, Iwr^Yd13, Iwr^Yd13, Iwr^Yd10, Xoc, Xoc, Rd, Rd, Rd
Rd, Rd, Rrc, Rrc, Rrc, Rrc, Xoc, Xoc, Ior, Ior, Ior, Xoc, Xoc, Xoc, Iwr, Iwr, Ior, Iwr, Iwr, Iwr, Iwr, Xoc, Xof, Rd
Rrc, Rrc, Rrc, Rrc, Xoc, Xoc, Ior, Ior, Ior, Iwr^Yd11, Iwr, Iwr^Yd13, Iwr, Iwr^Yd11, Iwr, Iwr, Iwr, Iwr^Yd11, Iwr, Ior, Xof, Xof, Iwr, Iwr
Xoc, Rrc, Rrc, Xof, Xof, Ior, Iwr, Iwr^Yd11, Iwr, Ior, Iwr^Yd11, Iwr, Iwr, Iwr, Iwr, Iwr^Yd12, Iwr, Iwr, Xof, Xof, Iwr, Iwr^Yd12, Rrc, Rrc
Ior, Xoc, Xoc, Rrc, Rrc, Xof, Xof, Iwr, Iwr, Iwr, Iwr, Iwr, Iwr^Yd12, Ior, Iwr, Iwr, Xoc, Xof, Iwr^Yd15, Iwr^Yd13, Rrc, Rrc, Rrc, Rrc
Ior, Ior, Ior, Xoc, Xoc, Rrc, Rrc, Xof, Xof, Ior, Iwr, Iwr, Iwr, Iwr, Xof, Rr^Pw/o, Rrc, Rrc, Rrc, Rrc, Rrc, Rrc, Rrc^Eqf, Rrc^Eqf
Ior, Ior, Ior, Ior, Ior, Xoc, Xoc, Rrc, Rrc^Yd16, Xof, Xof, Iwr, Xof, Xof, Rrc, Rrc, Rrc, Rrc, Rrc, Rrc, Rrc^Eqf, Rrc^Eqf, Gg, Gg
Ior, Ior, Ior, Ior, Ior, Ior, Xoc, Xoc, Rrc, Rrc, Rrc, Xof, Rrc, Rrc, Rrc, Rrc, Rrc, Rrc, Rrc, Rrc^Eqf, Gs, Gs, Gs^Fds, Gs^Fds
Ior, Ior, Ior, Ior, Xoc, Xoc, Rrc^Yd14, Rrc^Yd14, Rrc^Yd14, Rrc, Rrc, Rrc, Rrc, Rrc, Rrc, Rrc, Gg^Eqf, Rrc^Eqf, Rrc, Rrc, Rrc, Gs, Gs, Gd
Ior, Ior, Xoc, Xoc, Rrc^Yd14, Rrc^Yd14, Rrc^Yd14, Rrc^Yd14, Gg^Eqf, Gg^Eqf, Gg^Eqf, Rrc, Rrc, Rrc, Gg^Eqf, Gg^Eqf, Gg, Gs^Fds, Gs^Fds, Rrc, Rrc, Rrc, Rrc, Gs
Xoc, Xoc, Rrc, Rrc^Yd13, Rrc, Rrc^Yd14, Gg^Eqf, Gg^Eqf, Gg, Gg, Gg, Gg^Eqf, Gg^Eqf, Gg^Eqf, Gg, Gs^Fds, Gd, Gd, Gs, Gg, Gg, Rrc, Rrc, Rrc
Rrc, Rrc, Rrc, Rrc, Gs^Fds, Gs^Fds, Gs, Gg, Gg, Gg, Gg, Gg, Gg, Gd, Gg, Gs^Fds, Gs^Fds, Gs, Gg, Gs^Fds, Gs, Gd, Gs^Fds, Rrc
Rrc, Rrc, Gg, Gs^Fds, Gg, Gs^Fds, Gg, Gd, Gg, Gg, Gg, Gg, Gg, Gg, Gg, Gd, Gg, Gg, Gg, Gg, Gs, Gs, Gg, Gs^Fds
