Gg, Gg, Gs^Fms, Ds, Gs^Fms, Wwt, Gs^Fms, Ds, Gs^Fms, Ds, Gs^Fms, Gs^Fms, Gs^Fms, Gs^Fms, Gs^Fms, Gg^Gvs, Gs^Fms, Gg, Gs^Fms, Gs^Fms, Gs^Fms, Gg^Gvs
Gg, Gs^Fms, Gs^Fms, Gs^Fms, Gs^Fms, Gs^Fms, Ds, Gs^Fms, Ds, Gg, Gg, Gg, Gs^Fms, Gs^Fms, Gg, Gs^Fms, Gg, Gg^Gvs, Gg^Gvs, Gs^Fms, Gg^Gvs, Gg^Gvs
Gs^Fms, Gs^Fms, Gs^Fms, Gs^Fms, Gg, Gg, Gd, Ds, Xom, Xom, Xom, Gg, Gg, Gg, Rd, Gd, Gs^Fms, Gg, Gg, Gg, Gg^Gvs, Gg^Gvs
Gs^Fms, Gs^Fms, Gs^Fms, Gg, Gg, Rd, Xom, Xom, Ior^Yd13, Ior, Ior, Xom, Xom, Gg, Gg, Gg, Gg, Gs^Fms, Gs^Fms, Gg, Gs^Fms, Gs^Fms
Gs^Fms, Gg, Gs^Fds, Gg, Xom, Rr^Pw/, Iwr, Xom, Xom, Ior, Ior, Ior^Yd12, Ior, Xom, Xom, Gg, Gg, Gs^Fms, Gs^Fms, Gs^Fms, Gs^Fms, Gs^Fms
Gs^Fms, Gg^Gvs, Xof, Xom, Iwr^Yd15, Ior, Icn, Icn, Icn, Rr^Pw\o, Xom, Ior, Xom, Xom, Ior^Yd14, Xom, Xof, Gg, Gg, Gg, Gs^Fms, Gg^Gvs
Gg, Gg^Gvs, Gg, Xof, Xof, Icn, Icn, Icn^Yd11, Icn, Icn, Ior^Yd10, Xom, Ior, Ior, Xof, Xof, Gg, Gg, Rd, Gg, Gs^Fms, Gs^Fms
Gs^Fms, Gg, Gd, Gg, Gs^Fds, Xof, Xof, Icn, Ior, Ior, Ior, Ior, Xof, Rr^Pw/, Gg, Gs, Gg, Gs, Gg, Gs^Fms, Gs^Fms, Gg^Gvs
Gs^Fms, Gg, Gg, Rd, Gs^Fds, Gs^Fds, Gs^Fds, Xof, Xof, Ior^Ykit, Xof, Xof, Gs, Rd, Gd, Gg, Rd, Gg, Gs^Fms, Gs^Fms, Gg^Gvs, Gg^Gvs
Gs^Fms, Gs^Fms, Gg, Gg, Gg, Gg, Gg^Yd14, Gg^Yd14, Gg^Yd13, Xof, Gg, Gg, Gg, Gg, Gs^Fms, Gg, Gg, Gg, Gs, Gg^Gvs, Gs^Fms, Gg
Gg^Gvs, Gs^Fms, Gg^Gvs, Gg, Gs^Fms, Gg^Gvs, Gg, Gg^Gvs, Gg^Gvs, Gg, Gg, Gd, Gg, Gs^Fms, Gs^Fms, Gs^Fms, Gs^Fms, Gg, Gg, Gg, Gg, Gg^Gvs
Gg, Gg^Gvs, Gs^Fms, Gs^Fms, Uu^Gvs, Gs^Fms, Gg, Gg^Gvs, Gg, Gg^Gvs, Gg, Gs^Fms, Gs^Fms, Gs^Fms, Gs^Fms, Gs^Fms, Gs^Fms, Gs^Fms, Gg^Gvs, Gg, Rd, Rd
