Gg^Es, Gs, Gs, Gg, Gs^Fds, Gs^Fds, Gs^Fds, Gs^Fds, Gs^Fds, Gs^Fds, Gs^Fds, Gs^Fds, Gs^Fds, Gs^Fds, Gs^Fds, Gg, Gs^Fds, Gg, Gs^Fds, Gg, Gs^Fds, Gs^Fds
Gg, Gg, Gd, Gg, Gg, Gs^Fds, Gs^Fds, Gs^Fds, Gs^Fds, Gs^Fds, Gs^Fds, Gs^Fds, Gs^Fds, Gs^Fds, Gs^Fds, Gs^Fds, Gs^Fds, Gs^Fds, Gs^Fds, Gs^Fds, Gs^Fds, Gs^Fds
Gg^Edt, Gg, Gg^Es, Gd, Gg, Gg^Es, Gs^Fds, Gs^Fds, Gs^Fds, Gs^Fds, Gs^Fds, Gs^Fds, Gs^Fds, Gs^Fds, Gs^Fds, Gs^Fds, Gs^Fds, Gs^Fds, Gs^Fds, Gs^Fds, Gs^Fds, Gs^Fds
Gg^Es, Gs, Gg, Gs, Gs, Gg, Gs^Fds, Gs^Fds, Gs^Fds, Gs^Fds, Gs^Fds, Gs^Fds, Gs^Fds, Gs^Fds, Gs^Fds, Gs^Fds, Gs^Fds, Gs^Fds, Gs^Fds, Gs^Fds, Gs^Fds, Gs^Fds
Gg^Es, Gg^Es, Gg^Es, Gg, Gg, Gs^Fds, Gs^Fds, Gs^Fds, Gs^Fds, Gs^Fds, Gg, Gs^Fds, Gs^Fds, Gs^Fds, Gs^Fds, Gs^Fds, Gs^Fds, Gs^Fds, Gs^Fds, Gs^Fds, Gs^Fds, Gs^Fds
Gg, Gg, Gg, Gg, Gg, Gs^Fds, Gs^Fds, Gs^Fds, Gs^Fds, Gg, Gs, Gs^Fds, Gs^Fds, Gs^Fds, Gs^Fds, Gs^Fds, Gs^Fds, Gs^Fds, Gs^Fds, Gs^Fds, Gs^Fds, Gs^Fds
Gd, Gg, Gg, Gg, Gs, Gs^Fds, Gs^Fds, Gs^Fds, Gs^Fds, Gs^Fds, Gg, Gs^Fds, Gs, Gs^Fds, Gg, Gg, Gs^Fds, Gs^Fds, Gs^Fds, Gs^Fds, Gs^Fds, Gs^Fds
Rd, Gd, Gd, Gs, Gs^Fds, Gs^Fds, Gg, Gs^Fds, Gs, Gs, Gg, Gs^Fds, Gg^Es, Gg, Gs^Fds, Gs^Fds, Gs^Fds, Gs^Fds, Gs^Fds, Gs^Fds, Gg, Gs^Fds
Re, Rd, Rd, Gg^Es, Gg, Gd, Gg^Efm, Gs^Fds, Gs^Fds, Gg^Efm, Gg, Gg, Gg^Efm, Gg, Gg, Gs^Fds, Gs^Fds, Gs^Fds, Gs^Fds, Gs^Fds, Gs^Fds, Gs^Fds
Gd, Re, Re, Rd, Rd, Gd, Gd, Gg, Gg^Es, Gg, Gd, Gg, Gs, Gg, Gs^Fds, Gs^Fds, Gg, Gg, Gg, Gg, Gg, Gs^Fds
Rd, Gd, Gd, Rd, Re, Rd, Rd, Gd, Rd, Gd, Re, Gd, Gd, Gs^Fds, Gd, Gg, Gg^Es, Gg, Gd, Gs, Gg, Gg
Gs, Gs, Gs, Gd, Gd, Re, Re, Rd, Rd, Rd, Rd, Re^Es, Rd, Gd, Re, Gs^Es, Gd, Gs^Es, Rd, Rd, Rd, Gs^Es
Rd, Gs, Gs, Gd, Gg^Es, Gd, Gd, Rd, Gd, Rd, Gd, Rd, Rd, Rd, Re, Rd, Rd, Rd, Rd, Rd, Re, Rd
Gs, Gs^Efm, Gg^Efm, Gg^Efm, Gg, Gg, Gg, Gg, Gd, Gg^Es, Gg, Gd, Gs^Fds, Rd, Gd, Rd, Rd, Rd, Gd, Gd, Gd, Re
Rd, Gs, Gg, Gs, Gs, Gs, Gg, Gd, Gg, Gg, Gg, Gs^Fds, Gs^Efm, Gg^Efm, Gs, Gs, Gs^Fds, Gs, Gg, Gg^Es, Gg, Gd
Gg, Gg^Edt, Gg, Gs, Gg^Edt, Gg, Gg, Gg, Gg, Gg, Gs, Gs^Efm, Gg, Gg, Gg, Gs, Gg, Gs^Fds, Gs^Fds, Gg, Gg, Gg
