Rd, Gs, Gg^Qov, Gs, Gs, Gg, Gg, Gs^Fds, Gs^Fds, Gs^Fds, Gs^Fds, Gs^Fds, Gs^Fds, Gs^Fds, Gs^Fds, Gs^Fds, Gs^Fds, Gs^Fds, Gs^Fds, Wot, Wwt, Wot, Wwt, Wot
Gg, Rd, Gs^Qov, Gg, Gs, Gg, Gg, Gs^Fds, Gs^Fds, Gs^Fds, Gs^Fds, Gs^Fds, Gg, Gg, Gs^Fds, Gs^Fds, Gs^Fds, Gs^Fds, Gs^Fds, Gg, Wot, Wot, Wot, Wot
Gs^Qov, Rd, Rd, Gg^Qov, Gs^Qov, Gs^Fds, Gs, Gg, Gg, Gg, Gg^Qov, Gg^Qov, Xos, Gg, Gs^Fds, Gg, Gg, Gs^Fds, Gg, Gg, Wwt, Wot, Wot, Wot
Gg, Gs^Qov, Gg^Qov, Rd, Rd, Gs^Qov, Gg^Qov, Gg, Gg^Qov, Gs^Qov, Cd, Cd, Cd, Xos, Xos, Gg, Gg, Gg, Gs, Gg, Gg, Wwt, Wot, Wot
Wwt, Gg, Gg^Qov, Rd, Gg^Qov, Rd, Rd, Gg^Qov, Xos, Cd, Rr^Vhc, Rr^Vhc, Rr, Cd, Cd, Xos, Xos, Gs, Gg, Gg, Wot, Wwt, Wot, Wot
Wot, Wot, Wot, Gg^Qov, Gg^Qov, Gg^Qov, Xos, Rr^Pw/o, Rrc, Rr^Vhc, Rr^Vhc, Rr, Rr^Vhc, Rr^Vhc, Rr^Vhc, Cd, Cd, Xos, Xos, Gg, Wot, Wot, Wwt, Wwt
Wwt, Wwt, Wot, Gg^Qov, Cd, Cd, Rr^Vhc, Rr^Vhc, Rr^Vhc, Rrc, Rrc, Rr, Rr^Vhc, Rr^Vhc, Rr^Vhc, Rr^Vhc, Rr, Cd, Cd, Wot^Qov, Wot, Wwt, Wwt, Wwt
Wot, Wot, Wwt, Xos, Cd, Rr^Vhc, Rr, Rr, Rr^Vhc, Ww^Ewl, Rrc, Rrc, Rrc, Rr^Vhc, Rr, Rr, Cd, Cd, Cd, Wot^Qov, Wot^Qov, Wot, Wwt, Wwt
Wot, Wwt, Wwt, Xos, Cd, Rr^Vhc, Rr^Vhc, Rr^Vhc, Rrc, Ch, Ch, Ch, Ch, Ch, Gg^Ve, Cd, Kd^Qov, Kd^Qov, Kd^Qov, Cd, Cd, Wot^Qov, Wot, Wwt
Wot, Wot, Wwt, Xos, Cd, Rr^Vhc, Rr^Vhc, Rrc, Wwt^Qov, Wwt^Qov, Wwt^Qov, Wwt^Qov, Wwt^Qov, Rrc, Rrc, Cd, Cd, Kd^Qov, Kd^Qov, Kd^Qov, Cd, Xos, Wot, Wot
Wot, Wot, Wot, Xos, Cd, Rr^Vhc, Rr, Rrc, Rrc, Wwt^Qov, Wot^Qov, Wot^Qov, Wwt^Qov, Wwt^Qov, Rr, Rr, Rr^Vhc, Cd, Cd, Cd, Cd, Xos, Wot, Wot
Wot, Wot, Wot, Xos, Cd, Rr, Rr^Vhc, Rr^Vhc, Gs^Vh, Cd, Wwt^Qov, Wwt^Qov, Cd, Rrc, Rr^Vhc, Rr, Rr, Gs^Vh, Rr^Vhc, Gs^Vh, Cd, Xos, Wot, Wot
Wot, Wot, Wot, Xos, Wwt^Qov, Cd, Cd, Gs^Vh, Gs^Vh, Cd, Wot^Qov, Wwt^Qov, Cd, Gs^Vh, Gd, Gs^Vh, Gs^Vh, Rr, Cd, Cd, Xos, Xos, Wot, Wot
Wwt, Wwt, Wwt, Wot, Wot, Wwt^Qov, Gg^Qov, Cd, Cd, Cd, Wwt^Qov, Wwt^Qov, Cd, Rr^Vhc, Rr^Vhc, Gs^Vh, Cd, Cd, Gs^Qov, Xos, Wwt, Wwt, Wot, Wot
Wwt, Wwt, Wwt, Wot, Wot, Wwt, Wwt, Gs^Qov, Wwt^Qov, Wwt^Qov, Wot, Wwt^Qov, Wwt^Qov, Cd, Cd, Cd, Gg^Qov, Gs^Qov, Wwt, Wwt, Wwt, Wot, Wot, Wot
Wot, Wwt, Wwt, Wot, Wot, Wwt, Wot, Wwt, Wot, Wwt, Wot, Wot, Wot, Wwt^Qov, Wot^Qov, Wwt^Qov, Wwt, Wwt, Wot, Wwt, Wot, Wot, Wot, Wot
Wot, Wot, Wot, Wot, Wot, Wot, Wot, Wwt, Wot, Wot, Wot, Wot, Wot, Wot, Wot, Wwt, Wwt, Wwt, Wot, Wot, Wot, Wot, Wot, Wot
Wot, Wot, Wot, Wot, Wot, Wot, Wot, Wot, Wot, Wot, Wot, Wot, Wot, Wot, Gg, Wot, Wot, Wot, Wot, Wot, Wot, Wot, Wot, Wot
