Gs^Fds, Gs^Fds, Gs^Fds, Gs^Fds, Gs^Fds, Gs^Fds, Gs^Fds, Gs^Fds, Gs^Fds, Gs^Fds, Gs^Fds, Gs^Fds, Gs^Fds, Gs^Fds, Gs^Fds, Gs^Fds, Gs^Fds, Gs^Fds, Gs^Fds, Gs^Fds, Gs^Fds
Gs^Fds, Gs^Fds, Xom, Gs^Fds, Gs^Fds, Gs^Fds, Gs^Fds, Gs^Fds, Gg^Efm, Gs^Fds, Gg, Gs^Fds, Gd^Es, Gs^Fds, Gs^Fds, Gs^Fds, Gs^Fds, Gs^Fds, Xom, Gs^Fds, Gs^Fds
Gs^Fds, Gs^Fds, Xom, Xom, Xom, Gs^Fds, Gs^Efm, Gg, Gs, Gg, Xom, Gg, Gg, Gs, Gg, Gg, Xom, Xom, Xom, Gs^Fds, Gs^Fds
Gs^Fds, Gs^Fds, Xom, Rd, Rd, Xom, Xom, Gg^Efm, Xom, Xom, Rrc, Xom, Xom, Gg^Efm, Xom, Xom, Rd, Rd, Xom, Gs^Fds, Gs^Fds
Gs^Fds, Gs^Fds, Xom, Rd, Rd, Rd, Xom, Xom, Rrc, Rrc, Rrc, Rrc, Rrc, Xom, Xom, Rd, Rd, Rd, Xom, Gs^Fds, Gs^Fds
Gs^Fds, Gs^Fds, Xom, Rd, Xom, Xom, Rrc, Rrc, Rrc, Rrc, Gs^Fds, Rrc, Rrc, Rrc, Rrc, Xom, Xom, Rd, Xom, Gg^Efm, Gs^Fds
Gs^Fds, Gg, Xom, Xom, Rrc, Rrc, Rrc, Rrc, Gs^Fds, Gs^Fds, Rd, Gs^Fds, Gs^Fds, Rrc, Rrc, Rrc, Rrc, Xom, Xom, Gs^Fds, Gs^Fds
Gs^Fds, Gg^Efm, Xom, Rrc, Rrc, Rrc, Gs^Fds, Gs^Fds, Rd, Rd, Rd^Ecf, Rd, Rd, Gs^Fds, Gs^Fds, Rrc, Rrc, Rrc, Xom, Gs^Fds, Gs^Fds
Gs^Fds, Gs^Fds, Xom, Rrc, Rrc, Rrc, Rrc, Gs^Fds, Gs^Fds, Rd, Rd, Rd, Gs^Fds, Gs^Fds, Rrc, Rrc, Rrc, Rrc, Xom, Gs^Fds, Gs^Fds
Gs^Fds, Gs^Fds, Xom, Xom, Xom, Rrc, Rrc, Rrc, Rrc, Rr, Rr, Rr, Rrc, Rrc, Rrc, Rrc, Xom, Xom, Xom, Gs^Fds, Gs^Fds
Gs^Fds, Gs^Fds, Xom, Wwt, Wwt, Xom, Xom, Rrc, Rrc, Rrc, Rr, Rrc, Rrc, Rrc, Xom, Xom, Wwt, Wwt, Xom, Gs^Fds, Gs^Fds
Gs, Gg, Xom, Wwt, Wwt, Gg, Gg, Xom, Xom, Rrc, Rr, Rrc, Xom, Xom, Gg, Gg, Wwt, Wwt, Xom, Gg, Gg
Gs^Fds, Gg, Xom, Xom, Rr, Gs^Ebn, Wwt, Wwt, Xom, Rrc, Rr, Rrc, Xom, Wwt, Wwt, Gs^Ebn, Rr, Xom, Xom, Gg^Efm, Gs^Fds
Gs^Fds, Gs^Fds, Xom, Rrc, Rr, Xom, Xom, Wwt, Xom, Rrc, Rr, Rrc, Xom, Wwt, Xom, Xom, Rr, Rrc, Xom, Gs, Gs^Fds
Gs^Fds, Gs^Fds, Xom, Rrc, Rr, Rr, Rr, Xom, Xom, Rrc, Cme, Rrc, Xom, Xom, Rr, Rr, Rr, Rrc, Xom, Gs^Fds, Gg
Gs^Fds, Gs^Fds, Xof, Rrc, Rrc, Rr, Cme, Rrc, Rrc, Rrc, Cme, Rrc, Rrc, Rrc, Cme, Rr, Rrc, Rrc, Xof, Gg, Gs
Gs^Fds, Gg^Es, Gd, Xof, Xof, Rrc, Rrc, Cme, Cme, Cme, Rr, Cme, Cme, Cme, Rrc, Rrc, Xof, Xof, Gg, Gs, Gs^Fds
Gs^Fds, Gg^Efm, Gg, Xof, Rd, Xof, Xof, Rrc, Rrc, Rrc, Rr, Rrc, Rrc, Rrc, Xof, Xof, Rd, Xof, Gg, Gg^Es, Gs^Fds
Gs^Fds, Gs^Fds, Gg, Xof, Gg^Efm, Rd, Rd, Xof, Xof, Rrc, Rr, Rrc, Xof, Xof, Rd, Rd, Gs, Xof, Gg, Gs^Fds, Gs^Fds
Gs^Fds, Gs^Fds, Gg, Xof, Xof, Gs, Gg, Rd, Xof, Rrc, Rr, Rrc, Xof, Rd, Gg^Efm, Gg, Xof, Xof, Gg, Gs^Fds, Gs^Fds
Gs^Fds, Gg^Efm, Gs, Gg, Gs^Es, Gg, Xof, Rd, Xof, Rrc, Rr, Rrc, Xof, Rd, Xof, Gg, Gg, Gg^Es, Gs, Gd, Gg
Gg, Gd, Gg^Es, Gs, Gg, Gs, Gg, Xof, Xof, Xof, Rr^Pw|o, Xof, Xof, Xof, Gg, Gg, Gg^Efm, Gs^Es, Gs^Efm, Gs, Gs^Fds
Gs^Fds, Gg, Gs^Fds, Gs^Fds, Gs^Fds, Gg, Gg^Efm, Gg, Gg, Xof, Rr, Xof, Gg, Gg, Gg, Gs^Fds, Gs^Fds, Gg, Gg, Gs^Fds, Gs^Fds
Gs^Fds, Gg^Efm, Gs^Fds, Gs^Es, Gg, Gd, Gg, Gg, Xof, Xof, Rr, Xof, Xof, Gg^Efm, Gg, Gs^Fds, Gs^Fds, Gs^Fds, Gg, Gs^Fds, Gs^Fds
Gs^Fds, Gs^Fds, Gg^Efm, Gg, Gg^Efm, Gs, Gg, Xof, Gs, Gs, Gg, Gs, Gs, Xof, Gg, Gg, Gg, Gs^Fds, Gs^Fds, Gs^Fds, Gs^Fds
Gs^Fds, Gs^Fds, Gg, Gs^Fds, Gs^Fds, Gs^Fds, Gg, Gg, Gs^Efm, Gs, Gg, Gs, Gs, Gg^Es, Gg, Gg^Efm, Gd, Gg, Gs^Fds, Gs^Fds, Gs^Fds
Gs^Fds, Gs^Fds, Gs^Fds, Gs^Fds, Gg, Gs^Es, Gs, Gs, Gg, Gg, Gg, Gg, Gs, Gs, Gs, Gg, Gg, Gs^Fds, Gg, Gs^Fds, Gg
