Qxua, Qxua, Qxua, Qxua, Qxua, Qxua, Qxua, Qxua, Qxua, Qxua, Qxua, Qxua, Qxua, Qxua, Qxua, Qxua, Qxua, Qxua, Qxua, Qxua, Qxua
Qxua, Qxua, Qxua, Qxua, Qxua, Qxua, Qxua, Qxua, Xos, Qxua, Qxua, Qxua, Xos, Qxua, Qxua, Qxua, Qxua, Qxua, Qxua, Qxua, Qxua
Qxua, Qxua, Qxua, Qxua, Qxua, Qxua, Xos, Xos, Rrc, Xos, Xos, Xos, Rrc, Xos, Xos, Qxua, Qxua, Qxua, Qxua, Qxua, Qxua
Qxua, Qxua, Qxua, Qxua, Xoi, Xoi, Xoi, Rrc, Rrc, Rrc, Rrc, Rrc, Rrc, Rrc, Xoi, Xoi, Xoi, Qxua, Qxua, Qxua, Qxua
Qxua, Qxua, Xoi, Xoi, Cud, Cud, Rrc, Xoi, Xoi, Rrc, Rrc, Rrc, Xoi, Xoi, Rrc, Cud, Cud, Xoi, Xoi, Qxua, Qxua
Qxua, Qxua, Xos, Cud, Rrc, Rrc, Rrc, Rrc, Cud, Xoi, Rr^Pw|, Xoi, Cud, Rrc, Rrc, Rrc, Rrc, Cud, Xos, Qxua, Qxua
Qxua, Qxua, Xos, Rrc, Rrc, Rrc, Rrc, Rrc, Cud, Xoi, Kud, Xoi, Cud, Rrc, Rrc, Rrc, Rrc, Rrc, Xos, Qxua, Qxua
Qxua, Qxua, Xos, Rrc, Rrc, Rrc, Rrc, Rrc, Rrc, Cud, Cud, Cud, Rrc, Rrc, Rrc, Rrc, Rrc, Rrc, Xos, Qxua, Qxua
Qxua, Qxua, Xos, Rrc, Rrc, Rrc, Rrc, Rrc, Rrc, Rrc, Rrc, Rrc, Rrc, Rrc, Rrc, Rrc, Rrc, Rrc, Xos, Qxua, Qxua
Qxua, Qxua, Xos, Rrc, Rrc, Rrc, Xoi, Rrc, Rrc, Rrc, Rrc, Rrc, Rrc, Rrc, Xoi, Rrc, Rrc, Rrc, Xos, Qxua, Qxua
Qxua, Qxua, Xos, Rrc, Rrc, Rrc, Rrc, Xoi, Rrc, Rrc, Rrc, Rrc, Rrc, Xoi, Rrc, Rrc, Rrc, Rrc, Xos, Qxua, Qxua
Qxua, Qxua, Xos, Rrc, Rrc, Rrc, Rrc, Rrc, Rrc, Rrc, Rrc, Rrc, Rrc, Rrc, Rrc, Rrc, Rrc, Rrc, Xos, Qxua, Qxua
Qxua, Qxua, Xos, Rrc, Rrc, Rrc, Rrc, Rrc, Rrc, Rrc, Rrc, Rrc, Rrc, Rrc, Rrc, Rrc, Rrc, Rrc, Xos, Qxua, Qxua
Qxua, Qxua, Xos, Rrc, Rrc, Rrc, Rrc, Rrc, Cud, Cud, Cud, Cud, Cud, Rrc, Rrc, Rrc, Rrc, Rrc, Xos, Qxua, Qxua
Qxua, Qxua, Xos, Cud, Cud, Rrc, Cud, Cud, Xos, Xos, Cud, Xos, Xos, Cud, Cud, Rrc, Cud, Cud, Xos, Qxua, Qxua
Qxua, Qxua, Qxua, Xos, Xos, Cud, Cud, Xos, Urb, Urb, Urb, Urb, Urb, Xos, Cud, Cud, Xos, Xos, Qxua, Qxua, Qxua
Qxua, Qxua, Qxua, Qxua, Qxua, Xos, Xos, Xos, Urb, Urb, Urb^Yf56, Urb, Urb, Xos, Xos, Xos, Qxua, Qxua, Qxua, Qxua, Qxua
Qxua, Qxua, Qxua, Qxua, Qxua, Qxua, Qxua, Xos, Xos, Xos, Xos, Xos, Xos, Xos, Qxua, Qxua, Qxua, Qxua, Qxua, Qxua, Qxua
Qxua, Qxua, Qxua, Qxua, Qxua, Qxua, Qxua, Qxua, Qxua, Qxua, Qxua, Qxua, Qxua, Qxua, Qxua, Qxua, Qxua, Qxua, Qxua, Qxua, Qxua
Qxua, Qxua, Qxua, Qxua, Qxua, Qxua, Qxua, Qxua, Qxua, Qxua, Qxua, Qxua, Qxua, Qxua, Qxua, Qxua, Qxua, Qxua, Qxua, Qxua, Qxua
Qxua, Qxua, Qxua, Qxua, Qxua, Qxua, Qxua, Qxua, Qxua, Qxua, Qxua, Qxua, Qxua, Qxua, Qxua, Qxua, Qxua, Qxua, Qxua, Qxua, Qxua
