Rd, Rd, Xos, Rrc, Rrc, Rrc, Rrc, Rrc, Rrc, Rrc, Rrc, Rrc, Rrc, Rrc, Rrc, Rrc, Rrc, Rrc, Xos, Rd, Rd
Rd, Rd, Xos, Xos, Xos, Rrc, Rrc, Rrc, Rrc, Rrc, Rrc, Rrc, Rrc, Rrc, Rrc, Rrc, Xos, Xos, Xos, Rd, Rd^Dr
Rd, Rd, Xos, Rrc, Rrc, Xos, Xos, Rrc, Rrc, Rrc, Rrc, Rrc, Rrc, Rrc, Xos, Xos, Rrc, Rrc, Xos, Rd, Rd
Rd, Rd, Xos, Rrc, Rrc, Rrc, Rrc, Xos, Xos, Xos, Rr^Pr|, Xos, Xos, Xos, Rrc, Rrc, Rrc, Rrc, Xos, Rd, Rd
Rd^Dr, Rd, Xos, Rrc, Rrc, Rrc, Rrc, Rrc, Rrc, Xos, Rrc, Xos, Rrc, Rrc, Rrc, Rrc, Rrc, Rrc, Xos, Rd, Rd
Rd^Dr, Rd, Rd, Xos, Xos, Rrc, Rrc, Rrc, Rrc, Rrc, Rrc, Rrc, Rrc, Rrc, Rrc, Rrc, Xos, Xos, Rd, Rd^Dr, Rd
Dd, Rd, Rd^Edb, Rd, Rd, Xos, Xos, Rrc, Rrc, Rrc, Rrc, Rrc, Rrc, Rrc, Xos, Xos, Rd, Rd, Rd, Rd, Ds
Dd, Dd, Rd, Rd, Rd^Esd, Rd, Rd, Xos, Xos, Xos, Rr^Pr|o, Xos, Xos, Xos, Rd, Rd^Edb, Rd, Rd^Edb, Rd, Rd^Edp, Ds
Hd, Dd, Dd^Edp, Rd^Esd, Rd^Esd, Rd^Esd, Rd, Rd, Rd, Rd, Rd, Rd, Rd, Rd, Rd, Rd, Rd^Edt, Rd^Edt, Rd, Ds, Dd
Ds, Hd, Dd, Rd, Dd, Rd^Edb, Rd^Dr, Rd, Rd, Rd, Rd, Rd, Rd, Rd, Dd, Dd^Edt, Dd, Rd, Ds, Dd, Dd
Xos, Ds^Edp, Hd^Edt, Rd^Edt, Rd^Edt, Rd, Rd, Rd, Rd, Rd, Rd, Rd, Ds, Ds, Rd, Rd^Edt, Rd^Dr, Ds^Edp, Dd, Dd, Xos
Ds, Xos, Xos, Dd^Edt, Dd, Ds, Ds, Ds^Edt, Ds, Ds, Ds, Ds, Ds, Rd, Dd, Dd, Dd, Ds, Xos, Xos, Rd
Ds, Rd, Dd, Xos, Xos, Rd, Rd, Rd^Esd, Ds, Ds, Dd^Edp, Ds^Esd, Dd, Dd, Rd, Rd, Xos, Xos, Ds, Rd, Rd
Rd, Dd, Rd, Dd, Ds, Xos, Xos, Xos, Ds, Rd, Rd, Ds, Ds, Xos, Xos, Xos, Ds, Ds, Ds, Rd^Esd, Rd
Rd, Rd, Dd^Esd, Dd^Esd, Dd, Ds, Ds, Xos, Ds, Hd, Rd, Dd^Edp, Ds^Dr, Xos, Rd, Rd, Rd, Rd, Rd^Esd, Rd, Rd
Rd, Dd, Ds^Edp, Dd^Esd, Ds^Esd, Ds, Dd, Xos, Ds, Ds, Dd, Dd, Ds, Xos, Rd, Ds, Dd^Esd, Rd^Esd, Rd, Rd, Rd
Rd, Rd, Ds, Ds, Ds, Ds^Edb, Dd^Edb, Xos, Dd, Ds, Ds, Ds, Ds, Xos, Ds^Edb, Dd, Dd^Edp, Rd, Ds, Rd, Rd
Ds, Ds, Ds, Ds, Dd, Dd, Dd^Esd, Xos, Xos, Xos, Rr^Pr|o, Xos, Xos, Xos, Ds, Ds^Edp, Dd, Ds, Ds, Ds, Ds
Ds, Ds, Ds, Hd, Dd, Dd^Esd, Dd, Dd^Edb, Dd, Ds, Dd^Edp, Ds, Ds, Dd, Hd, Dd, Hd, Dd, Ds, Ds^Edp, Ds
Dd, Ds, Hd, Hd, Dd, Dd^Edp, Dd, Dd, Dd, Dd, Dd, Dd, Dd, Hd, Dd, Hd, Dd, Ds, Dd, Dd, Dd
Ds, Dd, Ds, Dd, Dd, Dd, Ds, Ds, Ds, Ds, Ds, Ds, Ds, Ds, Ds, Ds, Ds, Dd, Ds, Dd, Ds
